
NO ./textures/purple.xpm
SO ./textures/mossy.xpm
WE ./textures/blue.xpm
EA ./textures/brick.xpm


F  244,164,96
C 0, 206, 209
     
111111111111111
100000000111001
1000000001 1001111111111111111111
100000000111000000000000000000001
100000000000000000000000000000001
100000000000000000000000000000001
100111101111100000111111111111111   
10010000000010000001
10010000000010000001
1001000N000010000001
10010000000000000001
100111111111100000011111111111
100000000000000000000000000001
100000000000000000000000000001
100000000000000000000000000001
111111111111111111111111111111
      
1111111
1000001
1111111

